aboutDrawio=O draw.io
aboutDrawioDescription=draw.io jest darmowym edytorem diagramów
actualSize=Rzeczywisty rozmiar
add=Dodaj
addLayer=Dodaj warstwę
addToExistingDrawing=Dodaj do istniejącego rysunku
addWaypoint=Dodaj punkt kontrolny
advanced=Zaawansowane
align=Wyrównaj
alignment=Wyrównanie
allChangesLost=Wszystkie zmiany zostaną utracone!
angle=Kąt
apply=Zastosuj
arrange=Rozmieść
arrow=Strzałka
arrows=Strzałki
automatic=Automatyczny
autosave=Autozapis
autosize=Automatyczny rozmiar
background=Tło
backgroundColor=Kolor tła
basic=Podstawowe
block=Blok
blockquote=Cytat blokowy
bold=Pogrubienie
borderColor=Kolor obramowania
borderWidth=Szerokość obramowania
bottom=Dół
bottomAlign=Wyrównanie do dołu
bottomLeft=Lewy dół
bottomRight=Prawy dół
bulletedList=Lista punktowana
cancel=Anuluj
center=Środek
changeOrientation=Zmień orientację
circle=Koło
classic=Klasyczny
clearDefaultStyle=Wyczyść styl domyślny
clearWaypoints=Wyczyść punkty kontrolne
clipart=Clipart
collapse=Zwiń
collapseExpand=Zwiń/Rozwiń
collapsible=Zwijany
comic=Komiks
connect=Połącz
connection=Połączenie
connectionPoints=Punkty połączenia
constrainProportions=Zachowaj proporcje
copy=Kopiuj
copyConnect=Kopiuj przy połączeniu
copySize=Kopiuj rozmiar
create=Utwórz
curved=Zakrzywiony
custom=Własne
cut=Wytnij
dashed=Przerywany
decreaseIndent=Zmniejsz wcięcie
default=Domyślne
delete=Usuń
deleteColumn=Usuń kolumnę
deleteRow=Usuń wiersz
diagram=Diagram
diamond=Diament
diamondThin=Diament (cienki)
direction=Kierunek
distribute=Rozmieść
divider=Separator
document=Dokument
done=Gotowe
dotted=Kropkowany
doubleClickTooltip=Kliknij dwukrotnie, aby edytować
duplicate=Duplikuj
duplicateIt=Duplikuj {1}
east=Wschód
edit=Edytuj
editData=Edytuj dane
editDiagram=Edytuj diagram
editImage=Edytuj obraz
editLink=Edytuj link
editStyle=Edytuj styl
editTooltip=Edytuj
enterGroup=Wejdź do grupy
enterValue=Wprowadź wartość
entityRelation=Relacja encji
exitGroup=Wyjdź z grupy
expand=Rozwiń
export=Eksportuj
extras=Dodatki
file=Plik
fileNotFound=Nie znaleziono pliku
filename=Nazwa pliku
fill=Wypełnienie
fillColor=Kolor wypełnienia
fitPage=Dopasuj do strony
fitPageWidth=Dopasuj do szerokości strony
fitWindow=Dopasuj do okna
flip=Odbij
flipH=Odbij poziomo
flipV=Odbij pionowo
font=Czcionka
fontFamily=Rodzina czcionki
fontColor=Kolor czcionki
fontSize=Rozmiar czcionki
format=Format
formatPanel=Panel formatowania
general=Ogólne
global=Globalny
gradient=Gradient
gradientColor=Kolor gradientu
grid=Siatka
gridSize=Rozmiar siatki
group=Grupuj
guides=Prowadnice
heading=Nagłówek
height=Wysokość
help=Pomoc
hide=Ukryj
hideIt=Ukryj {1}
home=Strona główna
horizontal=Poziomo
horizontalFlow=Przepływ poziomy
horizontalTree=Drzewo poziome
html=HTML
image=Obraz
images=Obrazy
import=Importuj
increaseIndent=Zwiększ wcięcie
insert=Wstaw
insertColumnBefore=Wstaw kolumnę przed
insertColumnAfter=Wstaw kolumnę po
insertHorizontalRule=Wstaw linię poziomą
insertImage=Wstaw obraz
insertLink=Wstaw link
insertRowBefore=Wstaw wiersz przed
insertRowAfter=Wstaw wiersz po
invalidName=Nieprawidłowa nazwa
invalidOrMissingFile=Nieprawidłowy lub brakujący plik
italic=Kursywa
landscape=Poziomo
language=Język
layers=Warstwy
left=Lewo
leftAlign=Wyrównaj do lewej
leftToRight=Od lewej do prawej
line=Linia
lineend=Koniec linii
lineheight=Wysokość linii
linestart=Początek linii
linewidth=Szerokość linii
link=Link
links=Linki
loading=Ładowanie
lockUnlock=Zablokuj/Odblokuj
manual=Ręczny
middle=Środek
misc=Różne
more=Więcej
moreResults=Więcej wyników
move=Przesuń
moveSelectionTo=Przesuń zaznaczenie do {1}
navigation=Nawigacja
new=Nowy
noColor=Brak koloru
noFiles=Brak plików
noMoreResults=Brak więcej wyników
none=Brak
noResultsFor=Brak wyników dla '{1}'
normal=Normalny
north=Północ
numberedList=Lista numerowana
opacity=Przezroczystość
open=Otwórz
openArrow=Otwarta strzałka
openFile=Otwórz plik
openLink=Otwórz link
openSupported=Obsługiwany format to pliki .XML zapisane z tego programu
openInNewWindow=Otwórz w nowym oknie
openInThisWindow=Otwórz w tym oknie
options=Opcje
organic=Organiczny
orthogonal=Prostopadły
outline=Kontur
oval=Owal
pages=Strony
pageView=Widok strony
pageScale=Skala strony
pageSetup=Ustawienia strony
panTooltip=Spacja+Przeciągnij, aby przewinąć
paperSize=Rozmiar papieru
paste=Wklej
pasteHere=Wklej tutaj
pattern=Wzór
perimeter=Obwód
placeholders=Symbole zastępcze
plusTooltip=Kliknij, aby połączyć i sklonować (ctrl+klik aby sklonować, shift+klik aby połączyć)
portrait=Pionowo
position=Pozycja
posterPrint=Druk plakatu
preview=Podgląd
print=Drukuj
radialTree=Drzewo radialne
redo=Ponów
removeFormat=Usuń formatowanie
removeFromGroup=Usuń z grupy
removeIt=Usuń {1}
removeWaypoint=Usuń punkt kontrolny
rename=Zmień nazwę
renameIt=Zmień nazwę {1}
replace=Zastąp
replaceIt=Zastąp {1}
replaceExistingDrawing=Zastąp istniejący rysunek
reset=Resetuj
resetView=Resetuj widok
reverse=Odwróć
right=Prawo
rightAlign=Wyrównaj do prawej
rightToLeft=Od prawej do lewej
rotate=Obróć
rotation=Obrót
rounded=Zaokrąglony
save=Zapisz
saveAs=Zapisz jako
saved=Zapisano
scrollbars=Paski przewijania
search=Szukaj
searchShapes=Szukaj kształtów
selectAll=Zaznacz wszystko
selectEdges=Zaznacz krawędzie
selectFont=Wybierz czcionkę
selectNone=Odznacz wszystko
selectVertices=Zaznacz wierzchołki
setAsDefaultStyle=Ustaw jako styl domyślny
shadow=Cień
shape=Kształt
share=Udostępnij
shareLink=Udostępnij link do edycji
sharp=Ostry
show=Pokaż
showGrid=Pokaż siatkę
showGuides=Pokaż prowadnice
size=Rozmiar
solid=Ciągły
sourceSpacing=Odstęp od źródła
south=Południe
spacing=Odstęp
straight=Prosty
strikethrough=Przekreślenie
strokeColor=Kolor linii
style=Styl
subscript=Indeks dolny
superscript=Indeks górny
table=Tabela
targetSpacing=Odstęp od celu
text=Tekst
textAlignment=Wyrównanie tekstu
textOpacity=Przezroczystość tekstu
toBack=Na spód
toFront=Na wierzch
tooltips=Podpowiedzi
top=Góra
topAlign=Wyrównanie do góry
topLeft=Lewy góra
topRight=Prawy góra
transparent=Przezroczysty
turn=Obróć
uml=UML
underline=Podkreślenie
undo=Cofnij
ungroup=Rozgrupuj
url=URL
untitledLayer=Warstwa bez nazwy
vertical=Pionowo
verticalAlign=Wyrównanie pionowe
verticalFlow=Przepływ pionowy
verticalTree=Drzewo pionowe
view=Widok
waypoints=Punkty kontrolne
west=Zachód
width=Szerokość
wordWrap=Zawijanie wierszy
zoom=Powiększenie
zoomIn=Powiększ
zoomOut=Pomniejsz 